title : Eigenschaftenliste
newButton : Neu
check : Analyse
export : Exportieren
electionType : Wahlverfahren
election : Wahl
votes : Stimmen
elected : Gewählt
noResultYet : Es liegt noch kein Resultat vor.
successMessage : Das vorliegende Wahlverfahren erfüllt die gegebene Eigenschaft.
timeoutMessage : Die Analyse wurde durch einen Timeout abgebrochen.
failureMessage : Die Analyse konnte aufgrund eines Fehlers nicht ausgeführt werden. Es folgt die Fehlermeldung im Original.
failureExampleMessage :  Die gegebene Eigenschaft wird nicht erfüllt. Bei diesem Wahlergebnis ist die Eigenschaft verletzt.
single-choice : Einfache Wahl (Single-Choice)
approval : Zustimmungswahl (Ja/Nein zu jedem Kandidaten)
weighted-approval : Gewichtete Zustimmungswahl (Punktezahl für jeden Kandidaten)
preference : Präferenzwahl (Liste der Kandidaten geordnet nach Zustimmung)
unknown : Unbekannt
openDialogTitleText : Eigenschaftenliste Öffnen
saveDialogTitleText : Eigenschaftenliste Speichern
lookInLabelText : Suchen in
openButtonText : Öffnen
cancelButtonText : Abbrechen
fileNameLabelText : Dateiname
filesOfTypeLabelText : Dateityp
openApproveButtonToolTipText : Öffnen
openApproveButtonText : Öffnen
saveApproveButtonToolTipText : Speichern
saveApproveButtonText : Speichern
ancelButtonToolTipText : Abbrechen
fileNameHeaderText : Dateiname
upFolderToolTipText : Eine Ebene höher
homeFolderToolTipText : Home
newFolderToolTipText : Neuen Ordner erstellen
listViewButtonToolTipText : Listen Ansicht
newFolderButtonText : Neuen Ordner erstellen
renameFileButtonText : Umbennen
deleteFileButtonText : Löschen
filterLabelText : Dateityp
detailsViewButtonToolTipText : Details
fileSizeHeaderText : Größe
fileDateHeaderText : Zuletzt modifiziert
fileApproveRegex : (.)+\.list
fileDescription : BEAST-Eigenschaftenlisten-Datei (*.list)
objectCouldNotBeConvertedToString : Eigenschaftenliste konnte nicht in einen String zum speichern konvertiert werden.
objectCouldNotBeSavedError : Objekt konnte nicht gespeichert werden.
inputOutputErrorOpen : Fehler beim einlesen der Datei (Wahrscheinlich existiert sie nicht).
invalidFileFormatErrorMessage : Die gegebene Datei enthält kein gültiges BEAST-Eigenschaftenlisten-Format.
wrongEncodingError : Die Eigenschaftenliste enthält falsch kodierte Zeichen.
inputOutputErrorSave : Das Verzeichnis in dem gespeichert werden soll existiert nicht.
wrongFileNameError : Der angegebene Name entspricht nicht dem regulären Ausdruck '^[^*&%\s]+$'.
fileSuffix : .list